00000000000000000000
00000001111111000000
00000111111111110000
00001111111111110000
00001111111111111000
00011111100011111000
00011111000011111100
00011111000011111100
00011111000001111100
00011111000001111100
00011111000001111100
00011111000001111100
00011111000001111100
00011111000011111100
00011111000011111100
00011111100111111000
00001111111111111000
00001111111111110000
00000111111111110000
00000001111111000000


00000000000111110000
00000000001111110000
00000000011111110000
00000000111111110000
00000011111111110000
00000111111111110000
00000111111111110000
00000111111111110000
00000111001111110000
00000000001111110000
00000000001111110000
00000000001111110000
00000000001111110000
00000000001111110000
00000000001111110000
00000000001111110000
00000000001111110000
00000000001111110000
00000000001111110000
00000000000000000000


00000001111111000000
00000111111111110000
00001111111111111000
00001111111111111100
00011111100011111100
00011111100011111100
00011111000011111100
00000000000011111100
00000000000111111000
00000000001111111000
00000000111111110000
00000001111111100000
00000011111110000000
00000111111100000000
00001111111000000000
00001111111111111100
00011111111111111100
00011111111111111100
00111111111111111100
00000000000000000000

00000000011100000000
00000011111111100000
00001111111111110000
00001111111111111000
00011111100111111000
00011111000011111000
00000000000111111000
00000000001111110000
00000000011111110000
00000000011111110000
00000000011111111000
00000000000111111100
00000000000011111100
00000000000011111100
00011111000011111100
00011111100011111100
00011111111111111000
00001111111111111000
00000111111111100000
00000000111110000000


00000000000000000000
00000000000111110000
00000000001111110000
00000000011111110000
00000000111111110000
00000001111111110000
00000001111111110000
00000011111111110000
00000111110111110000
00001111100111110000
00011111000111110000
00111111000111110000
00111111111111111100
00111111111111111110
00111111111111111110
00111111111111111110
00000000000111111000
00000000000111110000
00000000000111110000
00000000000111110000



1111111111111111111111111111111111111111
1111111111111111111111111111111111111111
1111111110000000000000000000000000111111
1111111110000000000000000000000000111111
1111111110000000000000000000000000111111
1111111110000000000000000000000000111111
1111111100000000000000000000000000111111
1111111100000000000000000000000000111111
1111111100000000000000000000000000111111
1111111100000000000000000000000000111111
1111111100000000000111111111111111111111
1111111100000000011111111111111111111111
1111111100000000011111111111111111111111
1111111100000000011110000011111111111111
1111111100000000011100000000111111111111
1111111000000000000000000000000011111111
1111111000000000000000000000000011111111
1111111000000000000000000000000000111111
1111110000000000000000000000000000111111
1111110000000000000000000000000000011111
1111110000000000000000000000000000011111
1111110000000000011111100000000000001111
1111111000000000011111100000000000001111
1111111111111111111111111000000000001111
1111111111111111111111111000000000001111
1111111111111111111111111000000000001111
1111111111111111111111111000000000001111
1111111111111111111111111000000000001111
1111111111111001111111111000000000001111
1111110000000000011111111000000000001111
1111110000000000011111111000000000001111
1111110000000000011111110000000000001111
1111110000000000000000000000000000011111
1111110000000000000000000000000000111111
1111111100000000000000000000000000111111
1111111100000000000000000000000001111111
1111111111000000000000000000000011111111
1111111111000000000000000000000111111111
1111111111111000000000000000111111111111
1111111111111100000000000000111111111111


1111111111111111111111111111111111111111
1111111111111111111111111111111111111111
1111111111111100000000000000111111111111
1111111111111000000000000000011111111111
1111111111100000000000000000000111111111
1111111111000000000000000000000011111111
1111111110000000000000000000000001111111
1111111100000000000000000000000000111111
1111111100000000000000000000000000111111
1111111000000000000111100000000000111111
1111110000000000011111100000000000111111
1111110000000000011111111000011111111111
1111110000000000011111111111111111111111
1111110000000000011111111111111111111111
1111110000000000011111111111111111111111
1111110000000000111000000000001111111111
1111110000000000100000000000001111111111
1111100000000000000000000000000011111111
1111000000000000000000000000000011111111
1111000000000000000000000000000000111111
1111000000000000000000000000000000111111
1111000000000000000110000000000000111111
1111000000000000000111100000000000011111
1111000000000000011111111000000000001111
1111100000000000011111111000000000001111
1111110000000000011111111000000000001111
1111110000000000011111111000000000001111
1111110000000000011111111000000000001111
1111110000000000011111111000000000001111
1111110000000000011111111000000000001111
1111110000000000011111111000000000001111
1111110000000000011111111000000000011111
1111111000000000000000000000000000111111
1111111100000000000000000000000000111111
1111111100000000000000000000000000111111
1111111110000000000000000000000001111111
1111111111000000000000000000000011111111
1111111111100000000000000000000111111111
1111111111111100000000000000111111111111
1111111111111100000000000000111111111111


1111000000000000000000000000000000001111
1111000000000000000000000000000000001111
1111000000000000000000000000000000001111
1111000000000000000000000000000000001111
1111000000000000000000000000000000001111
1111000000000000000000000000000000001111
1111000000000000000000000000000000001111
1111000000000000000000000000000000001111
1111000000000000000000000000000000011111
1111110000000000000000000000000000111111
1111111111111111111111100000000001111111
1111111111111111111110000000000011111111
1111111111111111111110000000000011111111
1111111111111111111000000000001111111111
1111111111111111111000000000001111111111
1111111111111111111000000000011111111111
1111111111111111111000000000011111111111
1111111111111111100000000000111111111111
1111111111111111100000000000111111111111
1111111111111111000000000001111111111111
1111111111111111000000000001111111111111
1111111111111110000000000011111111111111
1111111111111110000000000011111111111111
1111111111111110000000000111111111111111
1111111111111100000000000111111111111111
1111111111111000000000000111111111111111
1111111111111000000000000111111111111111
1111111111111000000000001111111111111111
1111111111111000000000011111111111111111
1111111111111000000000011111111111111111
1111111111110000000000011111111111111111
1111111111110000000000011111111111111111
1111111111110000000000011111111111111111
1111111111110000000000011111111111111111
1111111111100000000000011111111111111111
1111111111100000000000011111111111111111
1111111111100000000000011111111111111111
1111111111100000000000011111111111111111
1111111111111111111111111111111111111111
1111111111111111111111111111111111111111


1111111111111100000000000001111111111111
1111111111111000000000000001111111111111
1111111111000000000000000000000111111111
1111111111000000000000000000000111111111
1111111100000000000000000000000011111111
1111111100000000000000000000000001111111
1111111000000000000000000000000000111111
1111110000000000000110000000000000111111
1111110000000000011111100000000000111111
1111110000000000011111100000000000111111
1111110000000000011111100000000000111111
1111110000000000011111100000000000111111
1111110000000000011111100000000000111111
1111111000000000001111100000000000111111
1111111000000000000110000000000001111111
1111111100000000000000000000000011111111
1111111100000000000000000000000011111111
1111111111000000000000000000000111111111
1111111111000000000000000000000111111111
1111111100000000000000000000000011111111
1111111100000000000000000000000001111111
1111110000000000000110000000000000111111
1111110000000000000110000000000000111111
1111110000000000011111100000000000011111
1111110000000000011111100000000000011111
1111100000000000111111111000000000001111
1111100000000000111111111000000000001111
1111100000000000111111111000000000001111
1111100000000000011111110000000000001111
1111110000000000011111100000000000011111
1111110000000000011111100000000000111111
1111110000000000000110000000000000111111
1111110000000000000000000000000000111111
1111110000000000000000000000000000111111
1111111100000000000000000000000011111111
1111111100000000000000000000000011111111
1111111111000000000000000000001111111111
1111111111100000000000000000011111111111
1111111111111111111111111111111111111111
1111111111111111111111111111111111111111


1111111111111111000000111111111111111111
1111111111111110000000011111111111111111
1111111111000000000000000000011111111111
1111111111000000000000000000011111111111
1111111100000000000000000000000111111111
1111111100000000000000000000000111111111
1111111000000000000000000000000011111111
1111110000000000000000000000000001111111
1111110000000000000110000000000000111111
1111110000000000011111100000000000111111
1111110000000001111111100000000000111111
1111100000000001111111110000000000111111
1111000000000001111111111000000000011111
1111000000000001111111111000000000011111
1111000000000001111111111000000000001111
1111100000000001111111111000000000001111
1111100000000001111111111000000000001111
1111110000000000011111100000000000001111
1111110000000000011111100000000000001111
1111110000000000000000000000000000001111
1111110000000000000000000000000000001111
1111111000000000000000000000000000001111
1111111100000000000000000000000000001111
1111111110000000000000000000000000001111
1111111111000000000000000000000000001111
1111111111110000000001111000000000001111
1111111111111100000111111000000000011111
1111111111111111111111111000000000011111
1111111111111111111111110000000000111111
1111111111000000011111100000000000111111
1111110000000000011111100000000000111111
1111110000000000011110000000000000111111
1111110000000000000000000000000001111111
1111110000000000000000000000000011111111
1111111100000000000000000000000011111111
1111111100000000000000000000000111111111
1111111111000000000000000000011111111111
1111111111100000000000000000011111111111
1111111111111100000000001111111111111111
1111111111111100000000001111111111111111
